111111111111111
1P0010000000C01
100010111111001
1C0000000000001
1000101111110E1
10001C000000001
111111111111111